Domain,Problem,Experiment Name,Total Landmarks,Individual LMs,Disjunctions,Overall,Unary Methods,Unary Action,Overall Action,Overall Method
Factories-simple,pfile11.hddl,lmc,56,5,51,1093,1,4,857,236
Factories-simple,pfile11.hddl,lmc-BD,55,6,49,1110,1,5,864,246
Factories-simple,pfile11.hddl,lmc-GZD,53,5,48,1502,1,4,826,676
Factories-simple,pfile11.hddl,lmc-BDpGZD,51,2,49,1698,1,1,853,845
Factories-simple,pfile11.hddl,lmc-VDM,64,11,53,1238,1,10,863,375
Factories-simple,pfile05.hddl,lmc,24,5,19,179,1,4,115,64
Factories-simple,pfile05.hddl,lmc-BD,23,2,21,179,1,1,127,52
Factories-simple,pfile05.hddl,lmc-GZD,24,2,22,245,1,1,124,121
Factories-simple,pfile05.hddl,lmc-BDpGZD,24,2,22,234,1,1,124,110
Factories-simple,pfile05.hddl,lmc-VDM,25,5,20,192,1,4,122,70
Factories-simple,pfile12.hddl,lmc,59,6,53,1596,1,5,1106,490
Factories-simple,pfile12.hddl,lmc-BD,61,5,56,1529,1,4,1087,442
Factories-simple,pfile12.hddl,lmc-GZD,55,2,53,1796,1,1,1127,669
Factories-simple,pfile12.hddl,lmc-BDpGZD,51,1,50,1773,1,0,1062,711
Factories-simple,pfile12.hddl,lmc-VDM,72,8,64,1860,1,7,1099,761
Factories-simple,pfile19.hddl,lmc,69,2,67,2297,1,1,1881,416
Factories-simple,pfile19.hddl,lmc-BD,71,4,67,2519,1,3,1956,563
Factories-simple,pfile19.hddl,lmc-GZD,69,1,68,3563,1,0,1907,1656
Factories-simple,pfile19.hddl,lmc-BDpGZD,73,2,71,3320,1,1,1979,1341
Factories-simple,pfile19.hddl,lmc-VDM,94,10,84,2613,1,9,2026,587
Factories-simple,pfile10.hddl,lmc,52,1,51,904,1,0,760,144
Factories-simple,pfile10.hddl,lmc-BD,52,2,50,893,1,1,769,124
Factories-simple,pfile10.hddl,lmc-GZD,51,2,49,1233,1,1,794,439
Factories-simple,pfile10.hddl,lmc-BDpGZD,51,2,49,1319,1,1,768,551
Factories-simple,pfile10.hddl,lmc-VDM,60,2,58,960,1,1,778,182
Factories-simple,pfile13.hddl,lmc,45,4,41,1179,1,3,939,240
Factories-simple,pfile13.hddl,lmc-BD,48,1,47,1281,1,0,1004,277
Factories-simple,pfile13.hddl,lmc-GZD,49,2,47,1785,1,1,991,794
Factories-simple,pfile13.hddl,lmc-BDpGZD,44,1,43,1961,1,0,923,1038
Factories-simple,pfile13.hddl,lmc-VDM,56,7,49,1302,1,6,969,333
Factories-simple,pfile15.hddl,lmc,58,4,54,1767,1,3,1156,611
Factories-simple,pfile15.hddl,lmc-BD,59,7,52,1704,1,6,1245,459
Factories-simple,pfile15.hddl,lmc-GZD,60,5,55,1958,1,4,1189,769
Factories-simple,pfile15.hddl,lmc-BDpGZD,57,4,53,2127,1,3,1183,944
Factories-simple,pfile15.hddl,lmc-VDM,66,10,56,1969,1,9,1215,754
Factories-simple,pfile03.hddl,lmc,14,1,13,44,1,0,38,6
Factories-simple,pfile03.hddl,lmc-BD,14,1,13,44,1,0,38,6
Factories-simple,pfile03.hddl,lmc-GZD,15,2,13,70,1,1,37,33
Factories-simple,pfile03.hddl,lmc-BDpGZD,15,1,14,65,1,0,35,30
Factories-simple,pfile03.hddl,lmc-VDM,14,1,13,44,1,0,38,6
Factories-simple,pfile16.hddl,lmc,67,4,63,2371,1,3,1689,682
Factories-simple,pfile16.hddl,lmc-BD,68,3,65,2186,1,2,1707,479
Factories-simple,pfile16.hddl,lmc-GZD,71,3,68,2728,1,2,1760,968
Factories-simple,pfile16.hddl,lmc-BDpGZD,74,3,71,2716,1,2,1699,1017
Factories-simple,pfile16.hddl,lmc-VDM,88,7,81,2611,1,6,1692,919
Factories-simple,pfile06.hddl,lmc,29,3,26,228,1,2,190,38
Factories-simple,pfile06.hddl,lmc-BD,29,3,26,225,1,2,189,36
Factories-simple,pfile06.hddl,lmc-GZD,29,1,28,315,1,0,192,123
Factories-simple,pfile06.hddl,lmc-BDpGZD,29,1,28,314,1,0,192,122
Factories-simple,pfile06.hddl,lmc-VDM,29,3,26,214,1,2,185,29
Factories-simple,pfile02.hddl,lmc,14,2,12,49,1,1,38,11
Factories-simple,pfile02.hddl,lmc-BD,14,2,12,49,1,1,38,11
Factories-simple,pfile02.hddl,lmc-GZD,15,1,14,75,1,0,37,38
Factories-simple,pfile02.hddl,lmc-BDpGZD,15,1,14,77,1,0,37,40
Factories-simple,pfile02.hddl,lmc-VDM,14,1,13,48,1,0,38,10
Factories-simple,pfile14.hddl,lmc,51,3,48,1407,1,2,998,409
Factories-simple,pfile14.hddl,lmc-BD,54,3,51,1501,1,2,1033,468
Factories-simple,pfile14.hddl,lmc-GZD,52,3,49,1730,1,2,1061,669
Factories-simple,pfile14.hddl,lmc-BDpGZD,52,3,49,1687,1,2,1041,646
Factories-simple,pfile14.hddl,lmc-VDM,67,7,60,1545,1,6,1019,526
Factories-simple,pfile04.hddl,lmc,18,2,16,89,1,1,70,19
Factories-simple,pfile04.hddl,lmc-BD,18,2,16,93,1,1,73,20
Factories-simple,pfile04.hddl,lmc-GZD,18,1,17,131,1,0,70,61
Factories-simple,pfile04.hddl,lmc-BDpGZD,18,1,17,135,1,0,70,65
Factories-simple,pfile04.hddl,lmc-VDM,18,3,15,88,1,2,69,19
Factories-simple,pfile07.hddl,lmc,30,5,25,385,1,4,261,124
Factories-simple,pfile07.hddl,lmc-BD,30,4,26,363,1,3,270,93
Factories-simple,pfile07.hddl,lmc-GZD,34,6,28,426,1,5,274,152
Factories-simple,pfile07.hddl,lmc-BDpGZD,34,6,28,436,1,5,277,159
Factories-simple,pfile07.hddl,lmc-VDM,35,7,28,393,1,6,267,126
Factories-simple,pfile20.hddl,lmc,54,7,47,1906,1,6,1379,527
Factories-simple,pfile20.hddl,lmc-BD,51,4,47,1957,1,3,1363,594
Factories-simple,pfile20.hddl,lmc-GZD,47,3,44,2926,1,2,1283,1643
Factories-simple,pfile20.hddl,lmc-BDpGZD,48,3,45,2723,1,2,1302,1421
Factories-simple,pfile20.hddl,lmc-VDM,59,7,52,1770,1,6,1356,414
Factories-simple,pfile09.hddl,lmc,32,2,30,439,1,1,323,116
Factories-simple,pfile09.hddl,lmc-BD,33,4,29,487,1,3,358,129
Factories-simple,pfile09.hddl,lmc-GZD,36,3,33,737,1,2,373,364
Factories-simple,pfile09.hddl,lmc-BDpGZD,33,3,30,584,1,2,340,244
Factories-simple,pfile09.hddl,lmc-VDM,37,4,33,500,1,3,353,147
Factories-simple,pfile08.hddl,lmc,37,1,36,466,1,0,388,78
Factories-simple,pfile08.hddl,lmc-BD,36,5,31,502,1,4,394,108
Factories-simple,pfile08.hddl,lmc-GZD,35,1,34,626,1,0,373,253
Factories-simple,pfile08.hddl,lmc-BDpGZD,35,1,34,584,1,0,376,208
Factories-simple,pfile08.hddl,lmc-VDM,40,5,35,475,1,4,400,75
Factories-simple,pfile17.hddl,lmc,73,5,68,2340,1,4,1937,403
Factories-simple,pfile17.hddl,lmc-BD,75,8,67,2395,1,7,1963,432
Factories-simple,pfile17.hddl,lmc-GZD,75,2,73,3332,1,1,1906,1426
Factories-simple,pfile17.hddl,lmc-BDpGZD,73,1,72,3366,1,0,1936,1430
Factories-simple,pfile17.hddl,lmc-VDM,96,13,83,2442,1,12,1986,456
Factories-simple,pfile01.hddl,lmc,10,2,8,21,1,1,16,5
Factories-simple,pfile01.hddl,lmc-BD,10,2,8,21,1,1,16,5
Factories-simple,pfile01.hddl,lmc-GZD,10,1,9,25,1,0,13,12
Factories-simple,pfile01.hddl,lmc-BDpGZD,10,1,9,25,1,0,13,12
Factories-simple,pfile01.hddl,lmc-VDM,10,2,8,21,1,1,16,5
Factories-simple,pfile18.hddl,lmc,79,4,75,3663,1,3,2472,1191
Factories-simple,pfile18.hddl,lmc-BD,82,4,78,3555,1,3,2539,1016
Factories-simple,pfile18.hddl,lmc-GZD,77,2,75,4553,1,1,2621,1932
Factories-simple,pfile18.hddl,lmc-BDpGZD,75,3,72,4659,1,2,2545,2114
Factories-simple,pfile18.hddl,lmc-VDM,122,11,111,4126,1,10,2615,1511
Freecell-Learned-ECAI-16,probfreecell-06-4.hddl,lmc,13,1,12,5418,1,0,4942,476
Freecell-Learned-ECAI-16,probfreecell-06-4.hddl,lmc-BD,13,1,12,304,1,0,229,75
Freecell-Learned-ECAI-16,probfreecell-06-4.hddl,lmc-GZD,12,1,11,4875,1,0,4524,351
Freecell-Learned-ECAI-16,probfreecell-06-4.hddl,lmc-BDpGZD,13,1,12,258,1,0,229,29
Freecell-Learned-ECAI-16,probfreecell-06-4.hddl,lmc-VDM,13,2,11,4777,1,1,4676,101
Freecell-Learned-ECAI-16,probfreecell-09-1.hddl,lmc,13,1,12,8206,1,0,8134,72
Freecell-Learned-ECAI-16,probfreecell-09-1.hddl,lmc-BD,13,1,12,295,1,0,231,64
Freecell-Learned-ECAI-16,probfreecell-09-1.hddl,lmc-GZD,13,1,12,9130,1,0,8979,151
Freecell-Learned-ECAI-16,probfreecell-09-1.hddl,lmc-BDpGZD,13,1,12,261,1,0,231,30
Freecell-Learned-ECAI-16,probfreecell-09-1.hddl,lmc-VDM,13,1,12,7871,1,0,7793,78
Freecell-Learned-ECAI-16,probfreecell-07-4.hddl,lmc,13,1,12,7322,1,0,7208,114
Freecell-Learned-ECAI-16,probfreecell-07-4.hddl,lmc-BD,13,1,12,301,1,0,231,70
Freecell-Learned-ECAI-16,probfreecell-07-4.hddl,lmc-GZD,13,1,12,6703,1,0,6280,423
Freecell-Learned-ECAI-16,probfreecell-07-4.hddl,lmc-BDpGZD,13,1,12,263,1,0,231,32
Freecell-Learned-ECAI-16,probfreecell-07-4.hddl,lmc-VDM,13,1,12,6829,1,0,6551,278
Freecell-Learned-ECAI-16,probfreecell-02-3.hddl,lmc,11,2,9,1875,1,1,1321,554
Freecell-Learned-ECAI-16,probfreecell-02-3.hddl,lmc-BD,13,1,12,1924,1,0,1190,734
Freecell-Learned-ECAI-16,probfreecell-02-3.hddl,lmc-GZD,10,2,8,856,1,1,561,295
Freecell-Learned-ECAI-16,probfreecell-02-3.hddl,lmc-BDpGZD,13,1,12,2133,1,0,587,1546
Freecell-Learned-ECAI-16,probfreecell-02-3.hddl,lmc-VDM,11,1,10,2018,1,0,1463,555
Freecell-Learned-ECAI-16,probfreecell-04-5.hddl,lmc,13,1,12,903,1,0,827,76
Freecell-Learned-ECAI-16,probfreecell-04-5.hddl,lmc-BD,13,1,12,543,1,0,467,76
Freecell-Learned-ECAI-16,probfreecell-04-5.hddl,lmc-GZD,12,1,11,4903,1,0,4344,559
Freecell-Learned-ECAI-16,probfreecell-04-5.hddl,lmc-BDpGZD,13,1,12,517,1,0,467,50
Freecell-Learned-ECAI-16,probfreecell-04-5.hddl,lmc-VDM,13,1,12,904,1,0,829,75
Freecell-Learned-ECAI-16,probfreecell-07-5.hddl,lmc,13,1,12,7769,1,0,7684,85
Freecell-Learned-ECAI-16,probfreecell-07-5.hddl,lmc-BD,13,1,12,307,1,0,232,75
Freecell-Learned-ECAI-16,probfreecell-07-5.hddl,lmc-GZD,13,1,12,8016,1,0,7632,384
Freecell-Learned-ECAI-16,probfreecell-07-5.hddl,lmc-BDpGZD,13,1,12,261,1,0,232,29
Freecell-Learned-ECAI-16,probfreecell-07-5.hddl,lmc-VDM,13,1,12,7107,1,0,6877,230
Freecell-Learned-ECAI-16,probfreecell-02-1.hddl,lmc,11,1,10,821,1,0,748,73
Freecell-Learned-ECAI-16,probfreecell-02-1.hddl,lmc-BD,13,1,12,1636,1,0,908,728
Freecell-Learned-ECAI-16,probfreecell-02-1.hddl,lmc-GZD,11,1,10,1052,1,0,836,216
Freecell-Learned-ECAI-16,probfreecell-02-1.hddl,lmc-BDpGZD,12,1,11,863,1,0,417,446
Freecell-Learned-ECAI-16,probfreecell-02-1.hddl,lmc-VDM,12,1,11,1585,1,0,994,591
Freecell-Learned-ECAI-16,probfreecell-06-1.hddl,lmc,13,1,12,5427,1,0,5242,185
Freecell-Learned-ECAI-16,probfreecell-06-1.hddl,lmc-BD,13,1,12,308,1,0,229,79
Freecell-Learned-ECAI-16,probfreecell-06-1.hddl,lmc-GZD,13,1,12,5360,1,0,4886,474
Freecell-Learned-ECAI-16,probfreecell-06-1.hddl,lmc-BDpGZD,13,1,12,263,1,0,229,34
Freecell-Learned-ECAI-16,probfreecell-06-1.hddl,lmc-VDM,13,1,12,5577,1,0,5253,324
Freecell-Learned-ECAI-16,probfreecell-12-4.hddl,lmc,13,1,12,7968,1,0,7933,35
Freecell-Learned-ECAI-16,probfreecell-12-4.hddl,lmc-BD,13,1,12,298,1,0,230,68
Freecell-Learned-ECAI-16,probfreecell-12-4.hddl,lmc-GZD,13,1,12,7779,1,0,7697,82
Freecell-Learned-ECAI-16,probfreecell-12-4.hddl,lmc-BDpGZD,13,1,12,260,1,0,230,30
Freecell-Learned-ECAI-16,probfreecell-12-4.hddl,lmc-VDM,13,1,12,5797,1,0,5769,28
Freecell-Learned-ECAI-16,probfreecell-03-4.hddl,lmc,12,1,11,1542,1,0,1225,317
Freecell-Learned-ECAI-16,probfreecell-03-4.hddl,lmc-BD,13,1,12,864,1,0,404,460
Freecell-Learned-ECAI-16,probfreecell-03-4.hddl,lmc-GZD,10,1,9,640,1,0,537,103
Freecell-Learned-ECAI-16,probfreecell-03-4.hddl,lmc-BDpGZD,13,1,12,1108,1,0,630,478
Freecell-Learned-ECAI-16,probfreecell-03-4.hddl,lmc-VDM,12,1,11,1363,1,0,1203,160
Freecell-Learned-ECAI-16,probfreecell-09-3.hddl,lmc,13,1,12,5364,1,0,5316,48
Freecell-Learned-ECAI-16,probfreecell-09-3.hddl,lmc-BD,13,1,12,328,1,0,229,99
Freecell-Learned-ECAI-16,probfreecell-09-3.hddl,lmc-GZD,13,1,12,5073,1,0,5039,34
Freecell-Learned-ECAI-16,probfreecell-09-3.hddl,lmc-BDpGZD,13,1,12,260,1,0,229,31
Freecell-Learned-ECAI-16,probfreecell-09-3.hddl,lmc-VDM,13,1,12,5601,1,0,5536,65
Freecell-Learned-ECAI-16,probfreecell-09-5.hddl,lmc,13,1,12,3769,1,0,3713,56
Freecell-Learned-ECAI-16,probfreecell-09-5.hddl,lmc-BD,13,1,12,273,1,0,230,43
Freecell-Learned-ECAI-16,probfreecell-09-5.hddl,lmc-GZD,13,1,12,7512,1,0,7454,58
Freecell-Learned-ECAI-16,probfreecell-09-5.hddl,lmc-BDpGZD,13,1,12,260,1,0,230,30
Freecell-Learned-ECAI-16,probfreecell-09-5.hddl,lmc-VDM,13,1,12,3725,1,0,3677,48
Freecell-Learned-ECAI-16,probfreecell-12-1.hddl,lmc,13,1,12,10640,1,0,10599,41
Freecell-Learned-ECAI-16,probfreecell-12-1.hddl,lmc-BD,13,1,12,298,1,0,230,68
Freecell-Learned-ECAI-16,probfreecell-12-1.hddl,lmc-GZD,13,1,12,9892,1,0,9828,64
Freecell-Learned-ECAI-16,probfreecell-12-1.hddl,lmc-BDpGZD,13,1,12,260,1,0,230,30
Freecell-Learned-ECAI-16,probfreecell-12-1.hddl,lmc-VDM,13,1,12,10902,1,0,10827,75
Freecell-Learned-ECAI-16,probfreecell-06-5.hddl,lmc,13,1,12,5777,1,0,5572,205
Freecell-Learned-ECAI-16,probfreecell-06-5.hddl,lmc-BD,13,1,12,311,1,0,232,79
Freecell-Learned-ECAI-16,probfreecell-06-5.hddl,lmc-GZD,12,1,11,4502,1,0,3927,575
Freecell-Learned-ECAI-16,probfreecell-06-5.hddl,lmc-BDpGZD,13,1,12,265,1,0,232,33
Freecell-Learned-ECAI-16,probfreecell-06-5.hddl,lmc-VDM,13,1,12,6639,1,0,6262,377
Freecell-Learned-ECAI-16,probfreecell-02-2.hddl,lmc,11,1,10,1814,1,0,1234,580
Freecell-Learned-ECAI-16,probfreecell-02-2.hddl,lmc-BD,13,1,12,1669,1,0,1313,356
Freecell-Learned-ECAI-16,probfreecell-02-2.hddl,lmc-GZD,10,1,9,979,1,0,670,309
Freecell-Learned-ECAI-16,probfreecell-02-2.hddl,lmc-BDpGZD,13,1,12,2393,1,0,657,1736
Freecell-Learned-ECAI-16,probfreecell-02-2.hddl,lmc-VDM,11,2,9,1870,1,1,1246,624
Freecell-Learned-ECAI-16,probfreecell-05-1.hddl,lmc,13,1,12,3074,1,0,3018,56
Freecell-Learned-ECAI-16,probfreecell-05-1.hddl,lmc-BD,13,1,12,290,1,0,228,62
Freecell-Learned-ECAI-16,probfreecell-05-1.hddl,lmc-GZD,12,2,10,5464,1,1,5070,394
Freecell-Learned-ECAI-16,probfreecell-05-1.hddl,lmc-BDpGZD,13,1,12,258,1,0,228,30
Freecell-Learned-ECAI-16,probfreecell-05-1.hddl,lmc-VDM,13,1,12,3140,1,0,3079,61
Freecell-Learned-ECAI-16,probfreecell-03-2.hddl,lmc,13,1,12,979,1,0,820,159
Freecell-Learned-ECAI-16,probfreecell-03-2.hddl,lmc-BD,13,1,12,843,1,0,558,285
Freecell-Learned-ECAI-16,probfreecell-03-2.hddl,lmc-GZD,12,2,10,2595,1,1,2058,537
Freecell-Learned-ECAI-16,probfreecell-03-2.hddl,lmc-BDpGZD,13,1,12,488,1,0,405,83
Freecell-Learned-ECAI-16,probfreecell-03-2.hddl,lmc-VDM,13,1,12,999,1,0,820,179
Freecell-Learned-ECAI-16,probfreecell-06-2.hddl,lmc,12,2,10,5383,1,1,5058,325
Freecell-Learned-ECAI-16,probfreecell-06-2.hddl,lmc-BD,13,1,12,325,1,0,231,94
Freecell-Learned-ECAI-16,probfreecell-06-2.hddl,lmc-GZD,13,1,12,7073,1,0,6807,266
Freecell-Learned-ECAI-16,probfreecell-06-2.hddl,lmc-BDpGZD,13,1,12,259,1,0,231,28
Freecell-Learned-ECAI-16,probfreecell-06-2.hddl,lmc-VDM,12,1,11,5212,1,0,4865,347
Freecell-Learned-ECAI-16,probfreecell-04-3.hddl,lmc,12,1,11,3540,1,0,2960,580
Freecell-Learned-ECAI-16,probfreecell-04-3.hddl,lmc-BD,13,1,12,503,1,0,466,37
Freecell-Learned-ECAI-16,probfreecell-04-3.hddl,lmc-GZD,11,1,10,3002,1,0,2549,453
Freecell-Learned-ECAI-16,probfreecell-04-3.hddl,lmc-BDpGZD,13,1,12,500,1,0,466,34
Freecell-Learned-ECAI-16,probfreecell-04-3.hddl,lmc-VDM,12,2,10,3851,1,1,3184,667
Freecell-Learned-ECAI-16,probfreecell-09-2.hddl,lmc,13,1,12,270,1,0,229,41
Freecell-Learned-ECAI-16,probfreecell-09-2.hddl,lmc-BD,13,1,12,277,1,0,229,48
Freecell-Learned-ECAI-16,probfreecell-09-2.hddl,lmc-GZD,13,1,12,255,1,0,229,26
Freecell-Learned-ECAI-16,probfreecell-09-2.hddl,lmc-BDpGZD,13,1,12,255,1,0,229,26
Freecell-Learned-ECAI-16,probfreecell-09-2.hddl,lmc-VDM,13,1,12,270,1,0,229,41
Freecell-Learned-ECAI-16,probfreecell-05-4.hddl,lmc,13,1,12,4372,1,0,3784,588
Freecell-Learned-ECAI-16,probfreecell-05-4.hddl,lmc-BD,13,1,12,279,1,0,229,50
Freecell-Learned-ECAI-16,probfreecell-05-4.hddl,lmc-GZD,12,1,11,4945,1,0,4822,123
Freecell-Learned-ECAI-16,probfreecell-05-4.hddl,lmc-BDpGZD,13,1,12,574,1,0,532,42
Freecell-Learned-ECAI-16,probfreecell-05-4.hddl,lmc-VDM,13,1,12,5384,1,0,4527,857
Freecell-Learned-ECAI-16,probfreecell-12-5.hddl,lmc,13,1,12,5617,1,0,5579,38
Freecell-Learned-ECAI-16,probfreecell-12-5.hddl,lmc-BD,13,1,12,302,1,0,231,71
Freecell-Learned-ECAI-16,probfreecell-12-5.hddl,lmc-GZD,13,1,12,264,1,0,231,33
Freecell-Learned-ECAI-16,probfreecell-12-5.hddl,lmc-BDpGZD,13,1,12,264,1,0,231,33
Freecell-Learned-ECAI-16,probfreecell-12-5.hddl,lmc-VDM,13,1,12,5027,1,0,4961,66
Freecell-Learned-ECAI-16,probfreecell-04-1.hddl,lmc,13,1,12,3920,1,0,3316,604
Freecell-Learned-ECAI-16,probfreecell-04-1.hddl,lmc-BD,13,1,12,541,1,0,470,71
Freecell-Learned-ECAI-16,probfreecell-04-1.hddl,lmc-GZD,12,1,11,3655,1,0,3094,561
Freecell-Learned-ECAI-16,probfreecell-04-1.hddl,lmc-BDpGZD,13,1,12,498,1,0,470,28
Freecell-Learned-ECAI-16,probfreecell-04-1.hddl,lmc-VDM,13,1,12,3625,1,0,2960,665
Freecell-Learned-ECAI-16,probfreecell-11-3.hddl,lmc,13,1,12,9585,1,0,9454,131
Freecell-Learned-ECAI-16,probfreecell-11-3.hddl,lmc-BD,13,1,12,300,1,0,231,69
Freecell-Learned-ECAI-16,probfreecell-11-3.hddl,lmc-GZD,13,1,12,10423,1,0,10347,76
Freecell-Learned-ECAI-16,probfreecell-11-3.hddl,lmc-BDpGZD,13,1,12,262,1,0,231,31
Freecell-Learned-ECAI-16,probfreecell-11-3.hddl,lmc-VDM,13,1,12,9562,1,0,9467,95
Freecell-Learned-ECAI-16,probfreecell-02-5.hddl,lmc,10,2,8,1840,1,1,1760,80
Freecell-Learned-ECAI-16,probfreecell-02-5.hddl,lmc-BD,12,1,11,1181,1,0,612,569
Freecell-Learned-ECAI-16,probfreecell-02-5.hddl,lmc-GZD,10,1,9,514,1,0,413,101
Freecell-Learned-ECAI-16,probfreecell-02-5.hddl,lmc-BDpGZD,13,1,12,1614,1,0,741,873
Freecell-Learned-ECAI-16,probfreecell-02-5.hddl,lmc-VDM,11,2,9,1739,1,1,1198,541
Freecell-Learned-ECAI-16,probfreecell-13-5.hddl,lmc,13,1,12,4551,1,0,4511,40
Freecell-Learned-ECAI-16,probfreecell-13-5.hddl,lmc-BD,13,1,12,320,1,0,231,89
Freecell-Learned-ECAI-16,probfreecell-13-5.hddl,lmc-GZD,13,1,12,7920,1,0,7882,38
Freecell-Learned-ECAI-16,probfreecell-13-5.hddl,lmc-BDpGZD,13,1,12,263,1,0,231,32
Freecell-Learned-ECAI-16,probfreecell-13-5.hddl,lmc-VDM,13,1,12,5387,1,0,5347,40
Freecell-Learned-ECAI-16,probfreecell-10-1.hddl,lmc,13,1,12,9176,1,0,9102,74
Freecell-Learned-ECAI-16,probfreecell-10-1.hddl,lmc-BD,13,1,12,314,1,0,231,83
Freecell-Learned-ECAI-16,probfreecell-10-1.hddl,lmc-GZD,13,1,12,9944,1,0,9884,60
Freecell-Learned-ECAI-16,probfreecell-10-1.hddl,lmc-BDpGZD,13,1,12,260,1,0,231,29
Freecell-Learned-ECAI-16,probfreecell-10-1.hddl,lmc-VDM,13,1,12,10141,1,0,10048,93
Freecell-Learned-ECAI-16,probfreecell-11-1.hddl,lmc,13,1,12,11796,1,0,11740,56
Freecell-Learned-ECAI-16,probfreecell-11-1.hddl,lmc-BD,13,1,12,279,1,0,230,49
Freecell-Learned-ECAI-16,probfreecell-11-1.hddl,lmc-GZD,13,1,12,1009,1,0,985,24
Freecell-Learned-ECAI-16,probfreecell-11-1.hddl,lmc-BDpGZD,13,1,12,255,1,0,230,25
Freecell-Learned-ECAI-16,probfreecell-11-1.hddl,lmc-VDM,13,1,12,9693,1,0,9638,55
Freecell-Learned-ECAI-16,probfreecell-02-4.hddl,lmc,12,1,11,1929,1,0,1158,771
Freecell-Learned-ECAI-16,probfreecell-02-4.hddl,lmc-BD,13,1,12,1834,1,0,520,1314
Freecell-Learned-ECAI-16,probfreecell-02-4.hddl,lmc-GZD,11,2,9,2474,1,1,1787,687
Freecell-Learned-ECAI-16,probfreecell-02-4.hddl,lmc-BDpGZD,13,1,12,2064,1,0,661,1403
Freecell-Learned-ECAI-16,probfreecell-02-4.hddl,lmc-VDM,12,1,11,1833,1,0,1054,779
Freecell-Learned-ECAI-16,probfreecell-08-1.hddl,lmc,13,1,12,7913,1,0,7819,94
Freecell-Learned-ECAI-16,probfreecell-08-1.hddl,lmc-BD,13,1,12,268,1,0,230,38
Freecell-Learned-ECAI-16,probfreecell-08-1.hddl,lmc-GZD,13,1,12,263,1,0,230,33
Freecell-Learned-ECAI-16,probfreecell-08-1.hddl,lmc-BDpGZD,13,1,12,263,1,0,230,33
Freecell-Learned-ECAI-16,probfreecell-08-1.hddl,lmc-VDM,13,1,12,7937,1,0,7887,50
Freecell-Learned-ECAI-16,probfreecell-04-2.hddl,lmc,12,1,11,3581,1,0,3178,403
Freecell-Learned-ECAI-16,probfreecell-04-2.hddl,lmc-BD,13,1,12,994,1,0,468,526
Freecell-Learned-ECAI-16,probfreecell-04-2.hddl,lmc-GZD,13,1,12,2838,1,0,2185,653
Freecell-Learned-ECAI-16,probfreecell-04-2.hddl,lmc-BDpGZD,13,1,12,2220,1,0,1864,356
Freecell-Learned-ECAI-16,probfreecell-04-2.hddl,lmc-VDM,12,1,11,3785,1,0,3274,511
Freecell-Learned-ECAI-16,probfreecell-03-3.hddl,lmc,11,2,9,1450,1,1,1336,114
Freecell-Learned-ECAI-16,probfreecell-03-3.hddl,lmc-BD,13,1,12,531,1,0,404,127
Freecell-Learned-ECAI-16,probfreecell-03-3.hddl,lmc-GZD,11,2,9,2592,1,1,2079,513
Freecell-Learned-ECAI-16,probfreecell-03-3.hddl,lmc-BDpGZD,13,1,12,856,1,0,804,52
Freecell-Learned-ECAI-16,probfreecell-03-3.hddl,lmc-VDM,11,1,10,1569,1,0,1452,117
Freecell-Learned-ECAI-16,probfreecell-07-1.hddl,lmc,13,1,12,4741,1,0,4676,65
Freecell-Learned-ECAI-16,probfreecell-07-1.hddl,lmc-BD,13,1,12,331,1,0,230,101
Freecell-Learned-ECAI-16,probfreecell-07-1.hddl,lmc-GZD,13,1,12,262,1,0,230,32
Freecell-Learned-ECAI-16,probfreecell-07-1.hddl,lmc-BDpGZD,13,1,12,262,1,0,230,32
Freecell-Learned-ECAI-16,probfreecell-07-1.hddl,lmc-VDM,13,1,12,4377,1,0,4312,65
Freecell-Learned-ECAI-16,probfreecell-10-3.hddl,lmc,13,1,12,5959,1,0,5910,49
Freecell-Learned-ECAI-16,probfreecell-10-3.hddl,lmc-BD,13,1,12,285,1,0,229,56
Freecell-Learned-ECAI-16,probfreecell-10-3.hddl,lmc-GZD,13,1,12,8316,1,0,8283,33
Freecell-Learned-ECAI-16,probfreecell-10-3.hddl,lmc-BDpGZD,13,1,12,261,1,0,229,32
Freecell-Learned-ECAI-16,probfreecell-10-3.hddl,lmc-VDM,13,1,12,4146,1,0,4085,61
Freecell-Learned-ECAI-16,probfreecell-05-3.hddl,lmc,12,1,11,3849,1,0,3714,135
Freecell-Learned-ECAI-16,probfreecell-05-3.hddl,lmc-BD,13,1,12,301,1,0,229,72
Freecell-Learned-ECAI-16,probfreecell-05-3.hddl,lmc-GZD,13,1,12,259,1,0,229,30
Freecell-Learned-ECAI-16,probfreecell-05-3.hddl,lmc-BDpGZD,13,1,12,259,1,0,229,30
Freecell-Learned-ECAI-16,probfreecell-05-3.hddl,lmc-VDM,12,1,11,4831,1,0,4537,294
Freecell-Learned-ECAI-16,probfreecell-05-2.hddl,lmc,12,2,10,4147,1,1,3911,236
Freecell-Learned-ECAI-16,probfreecell-05-2.hddl,lmc-BD,13,1,12,636,1,0,533,103
Freecell-Learned-ECAI-16,probfreecell-05-2.hddl,lmc-GZD,12,1,11,5705,1,0,5393,312
Freecell-Learned-ECAI-16,probfreecell-05-2.hddl,lmc-BDpGZD,13,1,12,564,1,0,533,31
Freecell-Learned-ECAI-16,probfreecell-05-2.hddl,lmc-VDM,11,1,10,4330,1,0,4017,313
Freecell-Learned-ECAI-16,probfreecell-12-3.hddl,lmc,13,1,12,288,1,0,231,57
Freecell-Learned-ECAI-16,probfreecell-12-3.hddl,lmc-BD,13,1,12,309,1,0,231,78
Freecell-Learned-ECAI-16,probfreecell-12-3.hddl,lmc-GZD,13,1,12,1843,1,0,1816,27
Freecell-Learned-ECAI-16,probfreecell-12-3.hddl,lmc-BDpGZD,13,1,12,258,1,0,231,27
Freecell-Learned-ECAI-16,probfreecell-12-3.hddl,lmc-VDM,13,1,12,303,1,0,231,72
Freecell-Learned-ECAI-16,probfreecell-11-4.hddl,lmc,13,1,12,7996,1,0,7954,42
Freecell-Learned-ECAI-16,probfreecell-11-4.hddl,lmc-BD,13,1,12,310,1,0,231,79
Freecell-Learned-ECAI-16,probfreecell-11-4.hddl,lmc-GZD,13,1,12,9578,1,0,9319,259
Freecell-Learned-ECAI-16,probfreecell-11-4.hddl,lmc-BDpGZD,13,1,12,264,1,0,231,33
Freecell-Learned-ECAI-16,probfreecell-11-4.hddl,lmc-VDM,13,1,12,10740,1,0,10446,294
Freecell-Learned-ECAI-16,probfreecell-11-2.hddl,lmc,13,1,12,10866,1,0,10825,41
Freecell-Learned-ECAI-16,probfreecell-11-2.hddl,lmc-BD,13,1,12,302,1,0,230,72
Freecell-Learned-ECAI-16,probfreecell-11-2.hddl,lmc-GZD,13,1,12,8261,1,0,8168,93
Freecell-Learned-ECAI-16,probfreecell-11-2.hddl,lmc-BDpGZD,13,1,12,261,1,0,230,31
Freecell-Learned-ECAI-16,probfreecell-11-2.hddl,lmc-VDM,13,1,12,9843,1,0,9786,57
Freecell-Learned-ECAI-16,probfreecell-11-5.hddl,lmc,13,1,12,3169,1,0,3130,39
Freecell-Learned-ECAI-16,probfreecell-11-5.hddl,lmc-BD,13,1,12,307,1,0,232,75
Freecell-Learned-ECAI-16,probfreecell-11-5.hddl,lmc-GZD,13,1,12,8235,1,0,8176,59
Freecell-Learned-ECAI-16,probfreecell-11-5.hddl,lmc-BDpGZD,13,1,12,263,1,0,232,31
Freecell-Learned-ECAI-16,probfreecell-11-5.hddl,lmc-VDM,13,1,12,3175,1,0,3135,40
Freecell-Learned-ECAI-16,probfreecell-03-5.hddl,lmc,12,2,10,2483,1,1,1905,578
Freecell-Learned-ECAI-16,probfreecell-03-5.hddl,lmc-BD,13,1,12,991,1,0,789,202
Freecell-Learned-ECAI-16,probfreecell-03-5.hddl,lmc-GZD,11,1,10,2572,1,0,2386,186
Freecell-Learned-ECAI-16,probfreecell-03-5.hddl,lmc-BDpGZD,12,1,11,1825,1,0,1431,394
Freecell-Learned-ECAI-16,probfreecell-03-5.hddl,lmc-VDM,12,1,11,1958,1,0,1279,679
Freecell-Learned-ECAI-16,probfreecell-07-3.hddl,lmc,12,1,11,7308,1,0,6886,422
Freecell-Learned-ECAI-16,probfreecell-07-3.hddl,lmc-BD,13,1,12,307,1,0,227,80
Freecell-Learned-ECAI-16,probfreecell-07-3.hddl,lmc-GZD,13,1,12,7243,1,0,6980,263
Freecell-Learned-ECAI-16,probfreecell-07-3.hddl,lmc-BDpGZD,13,1,12,263,1,0,227,36
Freecell-Learned-ECAI-16,probfreecell-07-3.hddl,lmc-VDM,12,1,11,6375,1,0,6021,354
Freecell-Learned-ECAI-16,probfreecell-13-1.hddl,lmc,13,1,12,282,1,0,232,50
Freecell-Learned-ECAI-16,probfreecell-13-1.hddl,lmc-BD,13,1,12,282,1,0,232,50
Freecell-Learned-ECAI-16,probfreecell-13-1.hddl,lmc-GZD,13,1,12,9347,1,0,9322,25
Freecell-Learned-ECAI-16,probfreecell-13-1.hddl,lmc-BDpGZD,13,1,12,266,1,0,232,34
Freecell-Learned-ECAI-16,probfreecell-13-1.hddl,lmc-VDM,13,1,12,282,1,0,232,50
Freecell-Learned-ECAI-16,probfreecell-08-4.hddl,lmc,13,1,12,9250,1,0,9191,59
Freecell-Learned-ECAI-16,probfreecell-08-4.hddl,lmc-BD,13,1,12,331,1,0,231,100
Freecell-Learned-ECAI-16,probfreecell-08-4.hddl,lmc-GZD,13,1,12,1330,1,0,1299,31
Freecell-Learned-ECAI-16,probfreecell-08-4.hddl,lmc-BDpGZD,13,1,12,262,1,0,231,31
Freecell-Learned-ECAI-16,probfreecell-08-4.hddl,lmc-VDM,13,1,12,8933,1,0,8502,431
Freecell-Learned-ECAI-16,probfreecell-10-4.hddl,lmc,13,1,12,265,1,0,231,34
Freecell-Learned-ECAI-16,probfreecell-10-4.hddl,lmc-BD,13,1,12,270,1,0,231,39
Freecell-Learned-ECAI-16,probfreecell-10-4.hddl,lmc-GZD,13,1,12,260,1,0,231,29
Freecell-Learned-ECAI-16,probfreecell-10-4.hddl,lmc-BDpGZD,13,1,12,260,1,0,231,29
Freecell-Learned-ECAI-16,probfreecell-10-4.hddl,lmc-VDM,13,1,12,265,1,0,231,34
Freecell-Learned-ECAI-16,probfreecell-04-4.hddl,lmc,12,1,11,3926,1,0,3416,510
Freecell-Learned-ECAI-16,probfreecell-04-4.hddl,lmc-BD,13,1,12,538,1,0,398,140
Freecell-Learned-ECAI-16,probfreecell-04-4.hddl,lmc-GZD,12,1,11,3877,1,0,3327,550
Freecell-Learned-ECAI-16,probfreecell-04-4.hddl,lmc-BDpGZD,13,1,12,582,1,0,398,184
Freecell-Learned-ECAI-16,probfreecell-04-4.hddl,lmc-VDM,12,1,11,3579,1,0,2579,1000
Freecell-Learned-ECAI-16,probfreecell-10-2.hddl,lmc,13,1,12,10982,1,0,10669,313
Freecell-Learned-ECAI-16,probfreecell-10-2.hddl,lmc-BD,13,1,12,282,1,0,231,51
Freecell-Learned-ECAI-16,probfreecell-10-2.hddl,lmc-GZD,13,1,12,9511,1,0,9434,77
Freecell-Learned-ECAI-16,probfreecell-10-2.hddl,lmc-BDpGZD,13,1,12,260,1,0,231,29
Freecell-Learned-ECAI-16,probfreecell-10-2.hddl,lmc-VDM,13,1,12,8387,1,0,8292,95
Freecell-Learned-ECAI-16,probfreecell-08-5.hddl,lmc,13,1,12,7333,1,0,7295,38
Freecell-Learned-ECAI-16,probfreecell-08-5.hddl,lmc-BD,13,1,12,279,1,0,231,48
Freecell-Learned-ECAI-16,probfreecell-08-5.hddl,lmc-GZD,13,1,12,5087,1,0,5039,48
Freecell-Learned-ECAI-16,probfreecell-08-5.hddl,lmc-BDpGZD,13,1,12,261,1,0,231,30
Freecell-Learned-ECAI-16,probfreecell-08-5.hddl,lmc-VDM,13,1,12,6578,1,0,6539,39
Freecell-Learned-ECAI-16,probfreecell-10-5.hddl,lmc,13,1,12,8812,1,0,8704,108
Freecell-Learned-ECAI-16,probfreecell-10-5.hddl,lmc-BD,13,1,12,344,1,0,231,113
Freecell-Learned-ECAI-16,probfreecell-10-5.hddl,lmc-GZD,13,1,12,261,1,0,231,30
Freecell-Learned-ECAI-16,probfreecell-10-5.hddl,lmc-BDpGZD,13,1,12,261,1,0,231,30
Freecell-Learned-ECAI-16,probfreecell-10-5.hddl,lmc-VDM,13,1,12,9698,1,0,9592,106
Freecell-Learned-ECAI-16,probfreecell-12-2.hddl,lmc,13,1,12,9886,1,0,9801,85
Freecell-Learned-ECAI-16,probfreecell-12-2.hddl,lmc-BD,13,1,12,306,1,0,228,78
Freecell-Learned-ECAI-16,probfreecell-12-2.hddl,lmc-GZD,13,1,12,7877,1,0,7810,67
Freecell-Learned-ECAI-16,probfreecell-12-2.hddl,lmc-BDpGZD,13,1,12,259,1,0,228,31
Freecell-Learned-ECAI-16,probfreecell-12-2.hddl,lmc-VDM,13,1,12,8678,1,0,8634,44
Freecell-Learned-ECAI-16,probfreecell-03-1.hddl,lmc,12,2,10,1730,1,1,1362,368
Freecell-Learned-ECAI-16,probfreecell-03-1.hddl,lmc-BD,13,1,12,857,1,0,433,424
Freecell-Learned-ECAI-16,probfreecell-03-1.hddl,lmc-GZD,11,1,10,2363,1,0,2269,94
Freecell-Learned-ECAI-16,probfreecell-03-1.hddl,lmc-BDpGZD,13,1,12,790,1,0,488,302
Freecell-Learned-ECAI-16,probfreecell-03-1.hddl,lmc-VDM,12,2,10,1896,1,1,1505,391
Freecell-Learned-ECAI-16,probfreecell-07-2.hddl,lmc,13,2,11,7741,1,1,7664,77
Freecell-Learned-ECAI-16,probfreecell-07-2.hddl,lmc-BD,13,1,12,352,1,0,231,121
Freecell-Learned-ECAI-16,probfreecell-07-2.hddl,lmc-GZD,13,1,12,2183,1,0,2152,31
Freecell-Learned-ECAI-16,probfreecell-07-2.hddl,lmc-BDpGZD,13,1,12,262,1,0,231,31
Freecell-Learned-ECAI-16,probfreecell-07-2.hddl,lmc-VDM,13,2,11,7245,1,1,7107,138
Freecell-Learned-ECAI-16,probfreecell-13-3.hddl,lmc,13,1,12,11509,1,0,11449,60
Freecell-Learned-ECAI-16,probfreecell-13-3.hddl,lmc-BD,13,1,12,278,1,0,230,48
Freecell-Learned-ECAI-16,probfreecell-13-3.hddl,lmc-GZD,13,1,12,6700,1,0,6633,67
Freecell-Learned-ECAI-16,probfreecell-13-3.hddl,lmc-BDpGZD,13,1,12,259,1,0,230,29
Freecell-Learned-ECAI-16,probfreecell-13-3.hddl,lmc-VDM,13,1,12,13250,1,0,13175,75
Freecell-Learned-ECAI-16,probfreecell-13-2.hddl,lmc,13,1,12,12699,1,0,12629,70
Freecell-Learned-ECAI-16,probfreecell-13-2.hddl,lmc-BD,13,1,12,307,1,0,228,79
Freecell-Learned-ECAI-16,probfreecell-13-2.hddl,lmc-GZD,13,1,12,260,1,0,228,32
Freecell-Learned-ECAI-16,probfreecell-13-2.hddl,lmc-BDpGZD,13,1,12,260,1,0,228,32
Freecell-Learned-ECAI-16,probfreecell-13-2.hddl,lmc-VDM,13,1,12,11682,1,0,11606,76
Freecell-Learned-ECAI-16,probfreecell-08-2.hddl,lmc,13,1,12,274,1,0,230,44
Freecell-Learned-ECAI-16,probfreecell-08-2.hddl,lmc-BD,13,1,12,321,1,0,230,91
Freecell-Learned-ECAI-16,probfreecell-08-2.hddl,lmc-GZD,13,1,12,265,1,0,230,35
Freecell-Learned-ECAI-16,probfreecell-08-2.hddl,lmc-BDpGZD,13,1,12,265,1,0,230,35
Freecell-Learned-ECAI-16,probfreecell-08-2.hddl,lmc-VDM,13,1,12,274,1,0,230,44
Freecell-Learned-ECAI-16,probfreecell-13-4.hddl,lmc,13,1,12,277,1,0,228,49
Freecell-Learned-ECAI-16,probfreecell-13-4.hddl,lmc-BD,13,1,12,306,1,0,228,78
Freecell-Learned-ECAI-16,probfreecell-13-4.hddl,lmc-GZD,13,1,12,260,1,0,228,32
Freecell-Learned-ECAI-16,probfreecell-13-4.hddl,lmc-BDpGZD,13,1,12,260,1,0,228,32
Freecell-Learned-ECAI-16,probfreecell-13-4.hddl,lmc-VDM,13,1,12,277,1,0,228,49
Freecell-Learned-ECAI-16,probfreecell-08-3.hddl,lmc,13,1,12,6898,1,0,6845,53
Freecell-Learned-ECAI-16,probfreecell-08-3.hddl,lmc-BD,13,1,12,306,1,0,228,78
Freecell-Learned-ECAI-16,probfreecell-08-3.hddl,lmc-GZD,13,1,12,7839,1,0,7724,115
Freecell-Learned-ECAI-16,probfreecell-08-3.hddl,lmc-BDpGZD,13,1,12,257,1,0,228,29
Freecell-Learned-ECAI-16,probfreecell-08-3.hddl,lmc-VDM,13,1,12,7308,1,0,7078,230
Freecell-Learned-ECAI-16,probfreecell-06-3.hddl,lmc,13,1,12,6050,1,0,5348,702
Freecell-Learned-ECAI-16,probfreecell-06-3.hddl,lmc-BD,13,1,12,327,1,0,229,98
Freecell-Learned-ECAI-16,probfreecell-06-3.hddl,lmc-GZD,13,1,12,5355,1,0,5206,149
Freecell-Learned-ECAI-16,probfreecell-06-3.hddl,lmc-BDpGZD,13,1,12,261,1,0,229,32
Freecell-Learned-ECAI-16,probfreecell-06-3.hddl,lmc-VDM,12,1,11,5700,1,0,5286,414
Freecell-Learned-ECAI-16,probfreecell-05-5.hddl,lmc,12,1,11,5212,1,0,5080,132
Freecell-Learned-ECAI-16,probfreecell-05-5.hddl,lmc-BD,13,1,12,826,1,0,534,292
Freecell-Learned-ECAI-16,probfreecell-05-5.hddl,lmc-GZD,12,1,11,4040,1,0,3532,508
Freecell-Learned-ECAI-16,probfreecell-05-5.hddl,lmc-BDpGZD,13,1,12,766,1,0,716,50
Freecell-Learned-ECAI-16,probfreecell-05-5.hddl,lmc-VDM,12,1,11,5622,1,0,5120,502
Freecell-Learned-ECAI-16,probfreecell-09-4.hddl,lmc,13,1,12,8343,1,0,8264,79
Freecell-Learned-ECAI-16,probfreecell-09-4.hddl,lmc-BD,13,1,12,327,1,0,230,97
Freecell-Learned-ECAI-16,probfreecell-09-4.hddl,lmc-GZD,13,1,12,9998,1,0,9699,299
Freecell-Learned-ECAI-16,probfreecell-09-4.hddl,lmc-BDpGZD,13,1,12,263,1,0,230,33
Freecell-Learned-ECAI-16,probfreecell-09-4.hddl,lmc-VDM,13,1,12,7284,1,0,7148,136
Hiking,p27.hddl,,,,,,,,,
